R 1280 720
NO ./textures/winter.xpm
SO ./textures/summer.xpm
WE ./textures/autumn.xpm

EA ./textures/spring.xpm

S   ./textures/tree.xpm
F 220,100,0
C 225,30,0


        1111111111111111111111111
        1000000000110000000000001
        1011000001110000002000001
        1001000000000000000000001
111111111011000001110000000000001
100000000011000001110111110111111
11110111111111011100000010001
11110111111111011101010010001
1100000011010101110000000000111111
10002000000000000000000000N00001
1000000000000000110111001000111111
1100000111010101110001111000111
11110111 1110101 101111000001
11111111 1111111 111111111111