R 1600 900
NO ./textures/redbrick.xpm
SO ./textures/north.xpm
WE ./textures/winter.xpm
EA ./textures/mount.xpm

S   ./textures/tree.xpm
F 80,137,66
C 204,229,255

1111111
1000001
1000001
1111111
 
        1111111111111111111111111
        1000000000110000000000001
        1011000001110020002000201
        1001000000000200200000001
111111111011000001110000200202001
100000000011000001110111110111111
11110111111111011100000010001
11110111111111011101010010001
1100000011010101110000000000111111
10002000000000000000000000N0000001
1000000000000000110111001000111111
1100000111010101110001111000111
11110111 1110101 101111000001
11111111 1111111 111111111111