R 1600 800
NO ./textures/redbrick.xpm
SO ./textures/north.xpm
WE ./textures/wood.xpm
EA ./textures/winter.xpm

S   ./textures/tree.xpm
F 0,102,0
C 204,229,255


        1111111111111111111111111
        1000000000110000000000001
        1011000001110000002000001
        1001000000000000000000001
111111111011000001110000000000001
100000000011000001110111110111111
11110111111111011100000010001
11110111111111011101010010001
1100000011010101110000000000111111
10002000000000000000000000E00001
1000000000000000110111001000111111
1100000111010101110001111000111
11110111 1110101 101111000001
11111111 1111111 111111111111